##########
#@#  #  .#
# #  $   #
# # #    #
# # # ####
#  $ $   #
#.     . #
##########
