##########
#@ ......#
# $#######
#        #
#  $$$$$ #
#        #
##########

