         ####
     #####   #
    ## $  $  ####
##### $  $ $ ##.#
#       $$  ##..#
#  ###### ###.. #
##$#  #    #... #
#     #    #... #
#  #$ ## ####...#
####  $ $$  ##..#
   ##  $ $  $...#
    #@$$  $ #  .#
    #   $ $  ####
    #####    #
        ######
