##########
#.#   .  #
# # # ####
# $ #  $ #
#       @# 
##########
