#########
#     @########
# #$###       #
# #   #  ### ##
#     #       # 
# ### ## # # ##
# ##     #   .#
# ## ### ######
#        #
##########
