########
#      #
#      #
# $ # .#
#@     #
########
