##########
#.#     .#
# # # ####
# $ #  $ #
#       @#
##########
